******
*A..1*
*.aa.*
*.aa.*
*3..2*
******