*a.....a*
*0.*2*..*
*..*a*..*
*..***..*
*..***..*
*..***..*
*..*A*..*
*..*.*..*
*....1..*