    ***a***
*0...1*
*.*.*.*
*2.A.2*
*.*.*.*
*1...0*
***a***